  ........
. ........
.  .......
. ........
.     ....
. ... ....
. .     ..
... ......
