                            g
................ ............
.        M     .        ..y .
. .............   .....     .
.G.... .....     ..    ......

.............. ............r.
............. Y..............
.  ..........R...............
